12
12
333333333333
300000000003
300000110003
300000000003
300220000003
300000002203
303300000003
300000000003
300000000003
300000000003
300001100003
333333333333
3
3
9
9